16 10
00 00 00 00 00 00 00 00 00 00 00 00 00 00 00 00
00 01 01 01 01 01 01 01 01 01 01 01 01 01 01 00
00 01 01 01 01 01 01 01 01 01 01 01 01 01 01 00
00 01 02 03 01 04 01 01 01 01 01 01 01 00 01 00
00 01 01 02 01 02 01 01 01 01 01 01 01 01 01 00
00 01 01 00 02 00 01 00 01 00 01 00 01 00 01 00
00 01 01 01 01 02 01 01 01 01 01 01 01 01 01 00
00 01 00 01 00 01 01 00 01 00 01 00 01 00 01 00
00 01 01 01 01 01 01 01 01 01 01 01 01 01 01 00
00 00 00 00 00 00 00 00 00 00 00 00 00 00 00 00

//00 wall
//01 grass
//02 brick
//03 player
//04 enemy
//05 bom