16 16
13 13 13 13 13 13 13 13 13 13 13 13 13 13 13 13
00 00 00 00 00 00 00 00 00 00 00 00 00 00 00 00
00 01 01 01 01 01 01 01 01 01 01 01 01 01 01 00
00 01 00 01 00 01 00 01 00 01 00 01 00 00 00 00
00 01 02 03 01 01 01 01 01 04 01 01 01 01 01 00
00 01 00 02 00 02 00 01 00 01 00 01 00 01 02 00
00 01 01 01 02 01 01 01 01 01 01 01 12 01 01 00
00 00 00 01 00 02 00 01 00 01 00 00 01 00 01 00
00 01 01 01 01 01 01 01 01 01 01 01 01 01 01 00
00 01 00 01 00 00 00 01 00 01 00 01 00 02 01 00
00 01 01 01 01 01 01 01 01 01 01 01 01 01 01 00
00 01 00 01 00 00 00 01 00 01 00 01 00 01 00 00
00 01 01 01 01 01 01 01 01 01 01 01 01 01 01 00
00 01 00 08 00 01 00 01 00 01 00 01 00 01 02 00
00 01 01 01 01 09 07 08 10 11 01 01 01 01 01 00
00 00 00 00 00 00 00 00 00 00 00 00 00 00 00 00

//00 wall
//01 grass
//02 brick
//03 player
//04 enemy normal
//05 enemy AI
//06 bom
//07 speed item
//08 add bom item
//09 add power bom
//10 teleport
//11 move brick
//12 enemy move brick
//14 enemy eat bom