15 15
00 00 00 00 00 00 00 00 00 00 00 00 00 00 00
00 01 01 01 01 01 01 01 01 01 01 01 01 01 00
00 01 00 01 00 01 00 01 00 01 00 01 00 01 00
00 01 02 03 00 04 01 01 01 01 01 01 01 01 00
00 01 00 02 00 02 00 01 00 01 00 01 00 01 00
00 01 01 01 02 01 01 01 01 01 01 01 01 01 00
00 01 00 01 00 02 00 01 00 01 00 01 00 01 00
00 01 01 01 01 01 01 01 01 01 01 01 01 01 00
00 01 00 01 00 01 00 01 00 01 00 01 00 01 00
00 01 01 01 01 01 01 01 01 01 01 01 01 01 00
00 01 00 01 00 01 00 01 00 01 00 01 00 01 00
00 01 01 01 01 01 01 01 01 01 01 01 01 01 00
00 01 00 08 00 01 00 01 00 01 00 01 00 01 00
00 01 01 01 01 09 07 08 10 01 01 01 01 01 00
00 00 00 00 00 00 00 00 00 00 00 00 00 00 00

//00 wall
//01 grass
//02 brick
//03 player
//04 enemy
//06 bom
//07 speed item
//08 add bom item
//09 add power bom
//10 teleport