16 16
13 13 13 13 13 13 13 13 13 13 13 13 13 13 13 13
00 00 00 00 00 00 00 00 00 00 00 00 00 00 00 00
00 03 01 02 01 09 02 01 01 01 02 01 02 01 01 00
00 01 00 01 00 01 00 01 00 01 00 02 00 02 00 00
00 02 02 01 01 01 02 01 01 04 01 02 01 01 01 00
00 01 00 01 00 02 00 02 00 02 00 01 00 01 00 00
00 01 02 01 02 01 01 01 01 01 01 02 12 01 01 00
00 01 00 01 00 02 00 02 00 01 00 00 01 00 04 00
00 02 02 01 02 12 10 07 01 02 02 02 01 01 01 00
00 01 00 01 00 01 00 02 00 02 00 01 00 02 00 00
00 02 02 01 01 01 01 02 01 06 01 01 01 02 01 00
00 01 00 01 00 01 00 01 00 01 00 01 00 01 00 00
00 01 01 01 01 01 01 02 02 02 01 01 01 02 01 00
00 04 00 02 00 01 00 01 02 01 00 01 00 02 00 00
00 01 02 01 01 01 02 02 14 01 01 01 01 02 08 00
00 00 00 00 00 00 00 00 00 00 00 00 00 00 00 00

//00 wall
//01 grass
//02 brick
//03 player
//04 enemy normal
//05 enemy AI
//06 bom
//07 speed item
//08 add bom item
//09 add power bom
//10 teleport
//11 move brick
//12 enemy move brick
//14 enemy eat bom
//15 time up
//16 anti bomb